#.#.#.#...#.#.#.#.
..................
#...............#.
..................
#.....#.#.#.....#.
..................
#.....#...#.....#.
..................
#.....#.#.#.....#.
..................
#...............#.
..................
#.#.#.#...#.#.#.#.
..................

#.#.#.#...#.#.#.#.
..................
#...............#.
..................
#.....#.#.#.....#.
..................
#.....#...#.....#.
..................
#.....#.#.#.....#.
..................
#...............#.
..................
#.#.#.#...#.#.#.#.
..................

#.#.#.#.#.#.#.#.#.
..................
#...............#.
..................
#.....#.#.#.....#.
..................
#.....#...#.....#.
..................
#.....#.#.#.....#.
..................
#...............#.
..................
#.#.#.#.#.#.#.#.#.
..................

#.#...#.#.#...#.#.
..................
#...............#.
.....#.....#......
........#.........
..................
#.....#...#.....#.
..................
........#.........
.....#.....#......
#...............#.
..................
#.#...#.#.#...#.#.
..................

#.......#.......#.
..................
..................
.....#.....#......
..................
..................
#...............#.
..................
..................
.....#.....#......
..................
..................
#.......#.......#.
..................