#.#.#.#.#.#.#.#.#.#.#.#.#.#.
............................
#.#.#.#.#.#.#.#.#.#.#.#.#.#.
............................
#.#.#.#.#.#.#.#.#.#.#.#.#.#.
............................
#.#.#.#.#.#.#.#.#.#.#.#.#.#.
............................
#.#.#.#.#.#.#.#.#.#.#.#.#.#.
............................
............................
.....#.#.#.#.#.#.#.#.#......
............................

#...#...#...#...#...#...#...
............................
#...#...#...#...#...#...#...
............................
#...#...#...#...#...#...#...
............................
#...#...#...#...#...#...#...
............................
............................
............................
............................
......#.#.#.#.#.#.#.#.......
............................

#...#...#...#...#...#...#...
............................
#...#...#...#...#...#...#...
............................
#...#...#...#...#...#...#...
............................
#...#...#...#...#...#...#...
............................
............................
............................
............................
............#...............
............................