..........#...........
......................
..#.#.#.#.#.#.#.#.#...
......................
..#.#.....#.....#.#...
......................
..#.......#.......#...
......................
#.#.#.#.#.#.#.#.#.#.#.
......................
..#.......#.......#...
......................
..#.#.....#.....#.#...
......................
..#.#.#.#.#.#.#.#.#...
......................
..........#...........
......................

......................
..........#...........
..#.#.#.......#.#.#...
..........#...........
..#.#...........#.#...
..........#...........
..#...............#...
.........#.#..........
.#.#.#.#.....#.#.#.#..
.........#.#..........
..#...............#...
..........#...........
..#.#...........#.#...
..........#...........
..#.#.#.......#.#.#...
..........#...........
......................
......................

......................
......................
..#.#.....#.....#.#...
......................
..#.......#.......#...
......................
..........#...........
......................
..#.#.#.#.#.#.#.#.#...
......................
..........#...........
......................
..#.......#.......#...
......................
..#.#.....#.....#.#...
......................
......................
......................

......................
......................
..#...............#...
..........#...........
......................
..........#...........
......................
.........#.#..........
...#.#.#.....#.#.#....
.........#.#..........
......................
..........#...........
......................
..........#...........
..#...............#...
......................
......................
......................

......................
......................
......................
......................
..........#...........
......................
..........#...........
......................
......#.#.#.#.#.......
......................
..........#...........
......................
..........#...........
......................
......................
......................
......................
......................

......................
......................
......................
......................
......................
......................
......................
......................
..........#...........
......................
......................
......................
......................
......................
......................
......................
......................
......................