..#.#.#.#.#.#.#.#.#.#.#.#.....
..............................
......#.#.#.#.#.#.#.#.........
..............................
....#.#.#.#.#.#.#.#.#.#.......
..............................
..#.#.#.#.#.#.#.#.#.#.#.#.....
#.........................#.#.
..#.#.#.#.#.#.#.#.#.#.#.#.....
..............................
....#.#.#.#.#.#.#.#.#.#.......
..............................
......#.#.#.#.#.#.#.#.........
..............................
..#.#.#.#.#.#.#.#.#.#.#.#.....
..............................

..............................
..............................
........#.#.#.#.#.#...........
..............................
........#.#.#.#.#.#...........
..............................
........#.#.#.#.#.#...........
..............................
........#.#.#.#.#.#...........
..............................
........#.#.#.#.#.#...........
..............................
........#.#.#.#.#.#...........
..............................
..............................
..............................

..............................
..............................
..............................
..............................
..........#.#.#.#.............
..............................
..........#.#.#.#.............
..............................
..........#.#.#.#.............
..............................
..........#.#.#.#.............
..............................
..............................
..............................
..............................
..............................

..............................
..............................
..............................
..............................
..............................
..............................
............#.#...............
..............................
............#.#...............
..............................
..............................
..............................
..............................
..............................
..............................
..............................

..............................
..............................
..............................
..............................
..............................
..............................
..............................
.............#................
..............................
..............................
..............................
..............................
..............................
..............................
..............................
..............................