#.#.#...#...#.#.#.
..................
....#...#...#.....
..................
#.#.#.#.#.#.#.#.#.
..................
#...#...#...#...#.
..................
#.#.#.#.#.#.#.#.#.
..................
....#...#...#.....
..................
#.#.#...#...#.#.#.
..................

#.#.#...#...#.#.#.
..................
....#...#...#.....
..................
#.#.#.#.#.#.#.#.#.
..................
#...#...#...#...#.
..................
#.#.#.#.#.#.#.#.#.
..................
....#...#...#.....
..................
#.#.#...#...#.#.#.
..................

#.#.#...#...#.#.#.
..................
....#...#...#.....
..................
#.#.#.#.#.#.#.#.#.
..................
#...#...#...#...#.
..................
#.#.#.#.#.#.#.#.#.
..................
....#...#...#.....
..................
#.#.#...#...#.#.#.
..................

..................
..................
........#.........
..................
......#.#.#.......
..................
....#...#...#.....
..................
......#.#.#.......
..................
........#.........
..................
..................
..................

..................
..................
..................
..................
........#.........
..................
........#.........
..................
........#.........
..................
..................
..................
..................
..................

..................
..................
..................
..................
..................
..................
........#.........
..................
..................
..................
..................
..................
..................
..................