#.#.#.#.#.#.#.#.#.#.#.#.
........................
#.....................#.
........................
#.....................#.
........................
#....#.#.#.#.#.#.#....#.
........................
#.....................#.
........................
#.....................#.
........................
#.#.#.#.#.#.#.#.#.#.#.#.
........................

..#.#.#.#.#.#.#.#.#.#...
........................
........................
#.....................#.
........................
#.....................#.
......#.#.#.#.#.#.......
#.....................#.
........................
#.....................#.
........................
........................
..#.#.#.#.#.#.#.#.#.#...
........................

....#.#.#.#.#.#.#.#.....
........................
........................
........................
#.....................#.
........................
#......#.#.#.#.#......#.
........................
#.....................#.
........................
........................
........................
....#.#.#.#.#.#.#.#.....
........................

......#.#.#.#.#.#.......
........................
........................
........................
........................
#.....................#.
........#.#.#.#.........
#.....................#.
........................
........................
........................
........................
......#.#.#.#.#.#.......
........................

........#.#.#.#.........
........................
........................
........................
........................
........................
#........#.#.#........#.
........................
........................
........................
........................
........................
........#.#.#.#.........
........................

..........#.#...........
........................
........................
........................
........................
........................
..........#.#...........
........................
........................
........................
........................
........................
..........#.#...........
........................

...........#............
........................
........................
........................
........................
........................
...........#............
........................
........................
........................
........................
........................
...........#............
........................