#.#.#...
......#.
..#.....
........

.#..#...
........
...#....
........