#.#.#.#.#.#.
............
#.#.#.#.#.#.
............

............
..#.#.#.#...
............
............